11111111111111111111111
10P00000000000000000001
10000000000000000000001
1000000000C000000000001
10000000000000000000001
100000000000000000E0001
11111111111111111111111