11111111111111111
10000000000000001
10000000000000001
1000P00000C000001
10000000000000001
1000000000000E001
11111111111111111