11111111111111111111111
10000000011000000000001
10000010000000000000001
10000010000000000000001
10000000011000000000001
10000000000000000000001
11111111111111111111111