11111111111111111111111
10P00000011000000000001
10000010000000000000001
10000010000000000000001
10000000011000000000001
100000000110000000E0001
11111111111111111111111