         1         
        101        
       10001       
      1000001      
     100000001     
    10000000001    
   1000000000001   
  100000000000001  
 10000000000000001 
1111111111111111111