11111111111111111111111
10P00000011000000000001
100000100000000000
10000010000000000E00001
10000000011000000000001
10000E0000000000000
11111111111111111111111