11111111111111111
10P00000011000001
10000010000000001
10000010000000001
100000000110000P1
10000000000000001
11111111111111111