11111111111111111111111
10P00000001000000000001
100000C00000000C0000001
1000000000C0000000E0001
10000000000011000000001
10000000100000000000001
11111111111111111111111